20 20 
P P P P P P P P P P P P P P P P P P P P
P P P P P P P P P P P P P P P P P P P P
P P P P P P P P P P P P P P P P P P P P
P P P P P P P P P P P P P P P P P P P P
P P P # # # # # P P P P P P P P P P P P
P P P P P D D P P P P P P P P P P P P P
P P P P P P P P P P P P P P P P P P P P
P P P P P P P P P P P P P P P P P P P P
P P P P P P P P P P P P P P P P P P P P
P P P P P P P P P P P P P P P P P P P P
P P P P P P P P P P P P P P P P P P P P
P P P P P P P P P P P P P P P P P P P P
P P P P P # # # # # P P P P P P P P P P
P P P P P # P P P # P P P P P P P P P P
P P P P P # P P P # P P P P P P P P P P
P P P P P # # # # # P P P P P P P P P P
P P P P P P P P P P P P P P P P P P P P
P P P P P P P P P P P P P P P P P P P P
P P P P P P P P P P P P P P P P P P P P
P P P P P P P P P P P P P P P P P P P P