10 10
- - - - - - - B - B
- F - - - - - - - -
- - - - - - - - - -
- - - - - - - - - -
- - - - - - - - - -
- BG - - - - - - - -
- - - - P - - - - -
- - - - - - - - - -
- - - - - - - - B -
- - PBS - - - - - - -