10 10
P P P P P P P P P P
P P P P P P P P P P
P P P P P P ITL ITR # P
P P P P P P IBL IBR # P
P D D D D P P P P P
P P P P P P P W W P
P P P P P P P W W P
P P P P P P P P P P
P P P P P P P P P P
P P P P P P P P P P