10 10
B B E # # P P P P P
B B P P P P P P P P
W P P P P P P P P P
W D P ITR P P P P P P
W P P I P P P P P P
P P P P P P P P P P
P P P P P P P P P P
P P P P P P P P P P
P P P P P P P P P P
W W W W W W W W W W