6 6
P P P P P D
D D D D D P
P P P P P D
D D D D D D
P P P P P P
P D P D P D