20 20 
P P P P P P P P P P P P P P P P P P P P
P P P P P P P P P P P P P P P P P P P P
P P P # # # # P P P P P P P P P P P P P
P P P GD P P P # P P P P P P P P P P P P
P P P # # # # # P P P P P P P P P P P P
P P P P P P P P P P P P P P P P P P P P
P P P P P P P P P P P P P P P P P P P P
P P P P P P P P P P P P P P P P P P P P
P P P P P P P P P P P P P P P P P P P P
P P P P P P P P P P P P P P P P P P P P
P P P P P P P P P P P P P P P P P P P P
P P P P P P P P P P P P P P P P P P P P
P P P P P # # # # # P P P P P P P P P P
P P P P P # P P P # P P P P P P P P P P
P P P P P # P P P # P P P P P P P P P P
P P P P P # # # # # P P P P P P P P P P
P P P P P P P P P P P P P P P P P P P P
P P P P P P P P P P P P P P P P P P P P
P P P P P P P P P P P P P P P P P P P P
P P P P P P P P P P P P P P P P P P P P